L,S,S,S,S,S,S,S,S,S,S,S,S,S,S,S,S,S,S,S,S,S,S,S,S,S,S,S,S,S,S,S,S,S,S,S,S,S,S,S,S,S,S,S,S,S,S,S,S,S,S,S,S,S,S,S,S,S,S,S,S,S,S,S,S,S,S,S,S,S,S,S,S,S,S,S,S,S,S,S,S,S,S,S,S,S,S,S,S,S,S,S,S,S,S,S,S,S,S,S,S,S,S,S,S,R,R,R,R,R,R,R
L,S,S,S,S,S,S,S,S,S,S,S,S,S,S,S,S,S,S,S,S,S,S,S,S,S,S,S,S,S,S,S,S,S,S,S,S,S,S,S,S,S,S,S,S,S,S,C,C,S,S,S,S,S,S,S,S,S,S,S,S,S,S,S,S,S,S,S,S,S,S,S,S,S,S,S,S,S,S,S,S,S,S,S,S,S,S,S,S,S,S,S,S,S,S,S,S,S,S,S,S,S,S,S,S,R,R,R,R,R,R,R
L,S,S,S,C,S,S,S,S,S,S,S,S,S,S,S,S,S,S,C,S,S,S,S,S,S,S,S,S,C,S,S,S,S,S,C,S,S,S,S,S,S,S,S,S,S,S,S,S,C,S,S,S,S,S,S,S,S,S,S,S,S,S,S,S,S,S,S,S,S,S,S,S,S,S,S,S,S,S,S,C,S,S,S,S,S,S,S,S,S,S,S,S,S,S,S,S,S,S,S,S,S,S,S,S,R,R,R,R,R,R,R
L,S,S,S,S,S,S,S,S,S,S,S,S,S,S,S,S,S,S,S,S,S,S,S,S,S,S,S,S,S,S,S,S,S,S,S,S,S,S,S,S,S,S,S,S,S,W,S,S,S,S,S,S,S,S,S,S,S,S,S,S,S,S,S,S,S,W,S,S,C,S,S,S,S,S,S,S,S,S,S,S,S,S,S,S,S,S,S,S,S,S,S,S,S,S,S,S,S,C,S,S,S,S,S,S,R,R,R,R,R,R,R
L,S,S,S,S,S,S,S,W,S,S,S,S,S,S,S,S,W,S,S,S,S,S,S,S,S,S,S,S,W,S,S,S,S,S,S,S,S,S,S,S,S,W,S,S,S,W,S,S,S,S,G,S,S,S,S,S,S,S,S,S,S,G,G,S,S,W,S,S,S,S,W,S,S,S,S,S,S,S,S,S,S,S,S,S,W,S,S,S,S,S,W,S,S,S,S,S,S,W,S,S,S,S,S,F,R,R,R,R,R,R,R
L,S,P,S,S,S,E1,S,W,S,S,S,S,S,S,E2,S,W,S,S,S,S,S,S,S,G,G,S,S,W,S,S,S,S,S,E1,S,S,G,S,G,S,W,S,S,S,W,S,S,S,G,G,G,S,S,S,S,E2,E1,S,S,G,G,G,G,S,W,S,S,S,S,W,S,S,S,S,S,G,S,S,G,S,S,S,S,W,E2,S,S,S,S,W,S,G,T2,G,S,S,W,S,S,S,S,G,G,R,R,R,R,R,R,R
L,G,G,G,G,G,G,G,G,G,G,G,S,S,G,G,G,G,G,S,S,S,S,E2,S,G,G,G,G,G,G,S,S,T2,G,G,G,G,G,T2,G,G,G,G,G,G,G,G,S,G,G,G,G,T2,G,G,G,G,G,G,S,G,G,G,G,G,G,T1,G,G,G,G,G,G,S,S,G,G,G,T1,G,S,E1,S,S,G,G,G,G,G,T2,G,T1,G,T2,G,G,G,G,G,T1,G,G,G,G,R,R,R,R,R,R,R
L,G,G,G,G,G,G,G,G,G,G,G,T1,T1,G,G,G,G,G,T2,T2,G,G,G,G,G,G,G,G,G,G,G,G,T2,G,G,G,G,G,T2,G,G,G,G,G,G,G,G,T1,G,G,G,G,T2,G,G,G,G,G,G,T2,G,G,G,G,G,G,G,G,G,G,G,G,G,T2,T2,G,G,G,G,G,G,G,G,G,G,G,G,G,G,T2,G,G,G,T2,G,G,G,G,G,G,G,G,G,G,R,R,R,R,R,R,R